question,1,2,3,4,5,6,7,didn't notice,total
"Q.1",0,0,0,0,1,3,4,0,8
"Q.2",0,0,0,0,5,1,2,0,8
"Q.3",0,0,0,0,1,0,7,0,8
"Q.4",0,0,0,0,2,1,5,0,8
"Q.5",0,0,0,0,1,3,4,0,8
"Q.6",0,0,0,2,1,2,3,0,8
"Q.7",0,0,0,1,3,2,2,0,8
"Q.8",0,1,0,1,0,4,2,0,8
"Q.9",1,0,0,1,2,1,3,0,8
"Q.10",0,1,1,2,0,1,3,0,8
"Q.11",0,0,2,3,3,0,0,0,8
